11111111151111111111
40000000000000000001
10000000000000000001
10001111100111110006
10001003000100000001
10001000000100000001
10001000000100000001
10001000000100300001
10001800000100000001
10001111102111110001
10000000100100000001
10000000100100000001
10000003100100000001
10000000100103000001
10000000100100000001
10001111100111110001
10000000000000000001
10000000000000000001
10000300000000000001
11111111111171111111