11111111111111111111
10000000000000000024
10000000000000000001
10001111111001111111
10001000000000000001
10001000000000000001
10001001111111110001
10001000001000010001
10001000301000010001
10001000001003000001
10001111001000000001
10000001001111111101
10000001001000100001
10003001001030100001
10000001001000108001
10001111001000100001
100000000b0000100301
10000000000000100001
10080000000000000001
11111111111111111111