11111111111111111111
10000000000000000001
10000000000000000001
10011111111111110001
10010000000000000001
10010000000000000001
10010011111111110001
10010010000000010001
10010010000000010001
10010010011110010001
10010010000010010001
100100100b0010010001
10010010000010010001
10010011111110010001
10010000000000010001
10010000000000010001
10011111111111111111
10000000000000000001
10000000020000000001
11111111151111111111