11111111111111111111
10000000000000000001
10000000000000000001
62000001111000001001
10000001001000001001
10000001301001111001
11111111001000031001
10000000001000001001
10000000001000001001
10011001111111001001
10010000000001000001
10010000000001111001
10011111011000010001
10010000001000010001
10010000001300810001
10000010001111110001
10000010000003000001
1000301000b000000001
10000000000000000001
11111111111111111111
