11111111111117111111
10000010000002000001
10011111111111111001
10010000000010000001
10010000000010000001
10010010011111001001
10000010000000001001
10000010000000001001
10010010111101001111
10010010100101001001
100100101b0101001001
10010010101101001001
10010010001001001001
10011110001001001001
10010011111111001001
10010000000000001001
10010000000000001001
10011111111100111001
10000000100000000001
11111111111111111111